
R 1080 720

NO ./img/papier.xpm
SO ./img/papier2.xpm
WE ./img/papier3.xpm
EA ./img/papier4.xpm
S ./img/sprite.xpm

F 220,200,200
C 220,200,255

11111111111111111111111111111
10000000001100000000000000001
10110000011100000000000010001
10010000000000000002000010001
10110000011100000000000010001
10000000001100000111011110001
11110111111111011100000010001
11110111111111011101010010001
11000000110101011100000010001
10002000000000001100000010001
10000000000000001101010010N01
10000000110101011111011110001
10110111111101011111011110001
11111111111111111111111111111
